index,gold_clean,predicted_answer,correct,response_length,confidence,completion_tokens,prompt_tokens,total_tokens
0,18,18,True,1010,0,273,117,390
1,3,3,True,690,0,180,78,258
2,70000,195000,False,941,0,341,109,450
3,540,180,False,656,0,174,87,261
4,20,140,False,1457,0,392,163,555
5,64,64,True,795,0,263,108,371
6,260,INVALID,False,3263,0,3072,94,3166
7,160,140,False,1318,0,401,122,523
8,45,120,False,2001,0,635,156,791
9,460,460,True,1007,0,271,112,383
10,366,366,True,886,0,279,112,391
11,694,694,True,950,0,313,117,430
12,13,12,False,1159,0,322,119,441
13,18,18,True,1075,0,378,110,488
14,60,60,True,1465,0,385,104,489
15,125,96,False,1131,0,326,146,472
16,230,230,True,671,0,182,105,287
17,57500,57500,True,1157,0,362,110,472
18,7,7,True,1082,0,323,81,404
19,6,6,True,1466,0,392,117,509
20,15,15,True,1346,0,379,115,494
21,14,8,False,1008,0,283,98,381
22,7,7,True,684,0,198,107,305
23,8,8,True,750,0,215,92,307
24,26,26,True,605,0,207,91,298
25,2,2,True,1050,0,314,120,434
26,243,243,True,1036,0,361,121,482
27,16,16,True,962,0,266,111,377
28,25,25,True,677,0,172,102,274
29,104,104,True,795,0,229,121,350
30,109,109,True,1552,0,585,91,676
31,80,80,True,898,0,304,115,419
32,35,35,True,832,0,233,93,326
33,70,70,True,886,0,285,83,368
34,23,23,True,646,0,222,93,315
35,9,9,True,720,0,227,104,331
36,75,75,True,864,0,299,96,395
37,2,2,True,1114,0,334,115,449
38,10,10,True,819,0,253,96,349
39,18,18,True,1401,0,412,125,537
40,8,8,True,650,0,193,96,289
41,200,200,True,1398,0,358,180,538
42,26,26,True,902,0,226,134,360
43,48,48,True,1421,0,426,113,539
44,20,160,False,995,0,318,129,447
45,104,104,True,1213,0,314,146,460
46,163,163,True,781,0,250,146,396
47,800,800,True,971,0,327,102,429
48,8,8,True,598,0,179,89,268
49,30,30,True,915,0,245,95,340
50,294,294,True,932,0,262,89,351
51,5,16,False,1671,0,542,101,643
52,15,15,True,882,0,272,114,386
53,40,40,True,1332,0,364,152,516
54,40,19,False,2207,0,476,134,610
55,14,14,True,761,0,230,102,332
56,3,3,True,663,0,181,97,278
57,83,83,True,1134,0,285,129,414
58,57,57,True,704,0,259,136,395
59,187,187,True,609,0,161,84,245
60,17,17,True,1055,0,310,90,400
61,1430,1430,True,632,0,216,114,330
62,25000,2500,False,1113,0,292,120,412
63,1596,1596,True,1252,0,370,121,491
64,300,300,True,928,0,261,145,406
65,36,36,True,1488,0,415,99,514
66,48,48,True,919,0,244,110,354
67,595,595,True,884,0,277,106,383
68,36,36,True,794,0,241,89,330
69,60,60,True,826,0,219,104,323
70,7425,7425,True,1156,0,328,105,433
71,60,60,True,750,0,172,96,268
72,221,221,True,785,0,221,102,323
73,255,255,True,1068,0,305,97,402
74,88,88,True,907,0,300,178,478
75,60,60,True,913,0,281,118,399
76,5,5,True,1979,0,580,139,719
77,100,100,True,1226,0,326,97,423
78,6,6,True,1075,0,317,95,412
79,70,70,True,737,0,225,100,325
80,10,10,True,1072,0,308,87,395
81,17,17,True,657,0,217,111,328
82,623,623,True,1060,0,322,82,404
83,600,600,True,610,0,184,84,268
84,15,15,True,883,0,277,76,353
85,44,44,True,957,0,252,135,387
86,22,22,True,747,0,220,140,360
87,9360,798.6,False,985,0,346,131,477
88,8000,8000,True,701,0,223,92,315
89,24,18,False,913,0,268,102,370
90,225,225,True,1106,0,323,138,461
91,28,28,True,1077,0,312,88,400
92,4,4,True,686,0,230,103,333
93,36,36,True,1062,0,298,136,434
94,348,348,True,1345,0,393,103,496
95,40,40,True,1304,0,394,94,488
96,3,3,True,764,0,215,84,299
97,12,12,True,999,0,274,106,380
98,5,5,True,1017,0,304,148,452
99,58,40,False,965,0,255,134,389
100,175,695,False,706,0,210,147,357
101,6,8.5,False,1089,0,321,129,450
102,26,15,False,1228,0,337,117,454
103,140,140,True,990,0,275,116,391
104,500,500,True,972,0,295,100,395
105,20,20,True,946,0,242,82,324
106,72,72,True,1195,0,390,96,486
107,3,3,True,1016,0,358,167,525
108,50,50,True,844,0,261,132,393
109,28,28,True,938,0,300,113,413
110,45,45,True,1057,0,296,139,435
111,16,16,True,1214,0,382,122,504
112,24,24,True,821,0,213,114,327
113,25,25,True,774,0,206,82,288
114,6,6,True,1194,0,346,133,479
115,90,0,False,1252,0,445,145,590
116,42,42,True,900,0,263,104,367
117,360,360,True,601,0,178,82,260
118,4,4,True,1274,0,304,125,429
119,95200,99076.92,False,1443,0,562,135,697
120,240,240,True,887,0,249,93,342
121,27,27,True,945,0,275,105,380
122,48,48,True,1228,0,435,113,548
123,50,50,True,810,0,222,89,311
124,10,10,True,761,0,201,122,323
125,10,10,True,688,0,209,169,378
126,82,82,True,742,0,210,107,317
127,120,120,True,676,0,181,87,268
128,880,880,True,1142,0,374,137,511
129,10000,40000,False,1674,0,549,115,664
130,30,30,True,581,0,190,106,296
131,940,940,True,684,0,190,86,276
132,60,60,True,1389,0,399,110,509
133,13,13,True,1039,0,253,98,351
134,720,720,True,655,0,200,80,280
135,40,40,True,829,0,236,98,334
136,6,6,True,807,0,204,96,300
137,29,29,True,1144,0,400,127,527
138,105,105,True,1142,0,290,125,415
139,70,70,True,752,0,214,98,312
140,20,20,True,988,0,276,91,367
141,400,400,True,1189,0,400,92,492
142,140,140,True,892,0,234,98,332
143,16,16.30,False,1105,0,364,109,473
144,20,20,True,1216,0,345,185,530
145,4000,4000,True,1233,0,357,100,457
146,2,2125,False,658,0,212,134,346
147,75,60,False,1126,0,348,177,525
148,30,30,True,698,0,187,119,306
149,16,16,True,953,0,255,93,348
150,4,4,True,1139,0,358,145,503
151,5,5,True,1379,0,469,143,612
152,4,4,True,947,0,265,93,358
153,48,48,True,1108,0,400,155,555
154,272,272,True,1410,0,393,123,516
155,280,280,True,1238,0,382,126,508
156,1400,1400,True,788,0,210,126,336
157,80,80,True,1340,0,394,155,549
158,34,34,True,864,0,279,103,382
159,15,3,False,584,0,191,111,302
160,16,16,True,681,0,210,107,317
161,32,32,True,1138,0,340,124,464
162,92,241.79,False,990,0,361,94,455
163,50,54,False,881,0,272,108,380
164,15,15,True,926,0,255,120,375
165,77,77,True,730,0,269,169,438
166,5,5,True,877,0,228,113,341
167,16,16,True,942,0,308,82,390
168,18,18,True,733,0,242,79,321
169,120,120,True,958,0,240,83,323
170,150,150,True,877,0,300,107,407
171,1210,1210,True,934,0,272,108,380
172,51,62,False,1015,0,294,114,408
173,18000,18000,True,1194,0,381,130,511
174,95,95,True,1134,0,337,151,488
175,15,15,True,1225,0,370,117,487
176,100,100,True,710,0,187,97,284
177,350,450,False,1536,0,506,145,651
178,122,122,True,1101,0,353,94,447
179,130,130,True,865,0,255,95,350
180,20,20,True,547,0,153,101,254
181,160,160,True,760,0,242,147,389
182,23,23,True,692,0,225,88,313
183,2,2,True,1371,0,428,186,614
184,25,25,True,1474,0,431,93,524
185,30,30,True,734,0,192,92,284
186,5,6,False,11555,0,3072,168,3240
187,106,106.12,False,1204,0,408,92,500
188,50,50,True,1011,0,326,121,447
189,34,34,True,931,0,310,120,430
190,360,360,True,752,0,207,81,288
191,5,5,True,737,0,199,89,288
192,91,91,True,959,0,297,107,404
193,24,24,True,946,0,298,173,471
194,10,10,True,635,0,180,93,273
195,12,12.00,True,643,0,222,92,314
196,120,120,True,904,0,219,93,312
197,6277,6277,True,697,0,203,104,307
198,320,320,True,1133,0,327,128,455
199,7500,15000,False,991,0,305,130,435
200,55,55,True,655,0,193,103,296
201,114,109000,False,736,0,219,122,341
202,100,100,True,1197,0,333,101,434
203,31,31,True,1222,0,364,148,512
204,98,98,True,888,0,266,112,378
205,98,110,False,842,0,288,139,427
206,860,860,True,1131,0,359,130,489
207,2600,2600,True,956,0,276,108,384
208,76,76,True,1064,0,302,113,415
209,145,145,True,998,0,312,89,401
210,10,10,True,1617,0,485,153,638
211,4,4,True,1142,0,364,108,472
212,5,5,True,867,0,270,98,368
213,250,250,True,1145,0,319,113,432
214,8,8,True,1250,0,427,114,541
215,44,44,True,550,0,177,112,289
216,220,220,True,1085,0,328,106,434
217,15,15,True,778,0,211,85,296
218,45,45,True,1141,0,382,96,478
219,54,54,True,972,0,309,110,419
220,70,70,True,1005,0,259,101,360
221,90,90,True,924,0,262,113,375
222,140,140,True,707,0,200,81,281
223,20000,20000,True,882,0,235,97,332
224,180,180,True,991,0,322,117,439
225,9,9,True,783,0,208,109,317
226,33,39,False,1194,0,326,120,446
227,9,9.00,True,820,0,342,167,509
228,1,1,True,1039,0,289,107,396
229,21,21,True,1561,0,425,139,564
230,276,276000,False,845,0,314,113,427
231,50,50,True,896,0,210,109,319
232,75,75,True,807,0,218,92,310
233,12,12,True,1089,0,310,104,414
234,21,28,False,892,0,235,104,339
235,10,10,True,690,0,173,108,281
236,31,6,False,1319,0,380,111,491
237,90,90,True,447,0,147,97,244
238,68,68,True,869,0,273,91,364
239,280,280,True,1401,0,383,140,523
240,21,21,True,1022,0,267,88,355
241,6,6,True,631,0,197,90,287
242,3,3,True,977,0,274,119,393
243,250,250,True,983,0,278,115,393
244,20,20,True,909,0,303,128,431
245,7,7,True,806,0,230,117,347
246,27000,27000,True,1182,0,366,140,506
247,32,32,True,537,0,191,127,318
248,300,300,True,749,0,218,87,305
249,5,5600,False,1741,0,492,118,610
250,17,17,True,1242,0,361,114,475
251,70,70,True,634,0,189,89,278
252,73,73,True,1402,0,449,95,544
253,18,18,True,508,0,151,90,241
254,84,84,True,817,0,244,117,361
255,192,192,True,873,0,304,102,406
256,45,45,True,1194,0,381,107,488
257,5600,5600,True,1404,0,408,103,511
258,6,6.00,True,552,0,184,108,292
259,168,168,True,1058,0,344,91,435
260,11,11,True,966,0,295,95,390
261,62,62,True,844,0,277,87,364
262,270,270,True,586,0,178,90,268
263,8,105,False,10689,0,3072,105,3177
264,400,400,True,847,0,242,89,331
265,9500,9500,True,1054,0,361,151,512
266,118000,138000,False,860,0,285,134,419
267,91,71,False,1341,0,414,134,548
268,1375,1375,True,850,0,227,102,329
269,4,4,True,724,0,192,90,282
270,762,762,True,588,0,212,128,340
271,20,20,True,1191,0,324,99,423
272,5,5.00,True,721,0,228,101,329
273,315,315,True,1412,0,413,132,545
274,3200,3200,True,945,0,275,129,404
275,138,138,True,1478,0,439,144,583
276,9,9,True,1464,0,461,120,581
277,4,4,True,1110,0,287,101,388
278,40,40,True,630,0,196,91,287
279,6,6,True,1208,0,400,83,483
280,7,7,True,657,0,195,93,288
281,2450,2450,True,1111,0,355,105,460
282,195,195,True,916,0,278,108,386
283,68,68,True,1014,0,281,144,425
284,360,360,True,953,0,276,153,429
285,21,21,True,494,0,158,78,236
286,90,90,True,1122,0,326,84,410
287,8,8,True,884,0,268,95,363
288,3,3,True,768,0,213,108,321
289,16,16,True,1094,0,337,115,452
290,390,390,True,1162,0,333,116,449
291,2,2,True,1430,0,352,103,455
292,75,75,True,1130,0,342,104,446
293,83,83,True,1047,0,306,133,439
294,3,3,True,869,0,221,108,329
295,370,370,True,780,0,263,140,403
296,3,3,True,1006,0,323,98,421
297,55,55,True,791,0,230,130,360
298,500,1100,False,669,0,223,130,353
299,31800,37800,False,1042,0,333,138,471
300,78,78,True,887,0,216,108,324
301,8,16,False,1167,0,301,140,441
302,15,15,True,1036,0,277,91,368
303,1300,1000,False,1422,0,418,134,552
304,3200,3300,False,883,0,259,111,370
305,4,4,True,700,0,207,77,284
306,10,10,True,932,0,268,103,371
307,16,4,False,1226,0,317,109,426
308,6,6,True,878,0,241,106,347
309,8,8,True,1066,0,276,115,391
310,2050,2050,True,1007,0,322,151,473
311,91,91,True,939,0,264,93,357
312,32,32,True,495,0,165,84,249
313,120000,120000,True,1102,0,362,115,477
314,30,30,True,1467,0,447,106,553
315,14,14,True,1300,0,330,109,439
316,156,156,True,1052,0,329,121,450
317,12,12,True,945,0,283,90,373
318,123,123,True,1160,0,345,103,448
319,15,15,True,887,0,221,118,339
320,8,8,True,1323,0,379,102,481
321,1,1,True,919,0,260,84,344
322,9,9,True,1057,0,297,100,397
323,75,75,True,1287,0,371,134,505
324,14,14,True,880,0,211,112,323
325,224000,224000,True,1494,0,438,131,569
326,14,14,True,727,0,219,121,340
327,31,37,False,1121,0,361,131,492
328,2,2,True,923,0,248,96,344
329,14,14,True,549,0,176,100,276
330,31,31,True,1121,0,292,130,422
331,8400,4.29,False,1916,0,723,158,881
332,44,44,True,706,0,203,95,298
333,100,100,True,986,0,291,133,424
334,6,6,True,615,0,185,108,293
335,310,310,True,880,0,248,105,353
336,72,72,True,1044,0,364,102,466
337,1,1,True,932,0,244,88,332
338,60,60,True,931,0,285,110,395
339,160,160,True,875,0,276,90,366
340,4,4,True,910,0,260,175,435
341,260,260,True,1141,0,324,124,448
342,87,87,True,832,0,235,114,349
343,180000,180000,True,934,0,280,114,394
344,2,2,True,1132,0,329,102,431
345,310,310,True,768,0,211,85,296
346,9,9,True,1008,0,306,120,426
347,36,24,False,849,0,256,93,349
348,10,10,True,1407,0,395,121,516
349,2640,2640,True,1018,0,313,118,431
350,8,8,True,926,0,300,130,430
351,10,10,True,984,0,261,120,381
352,21,21,True,782,0,201,95,296
353,20,20,True,1130,0,343,128,471
354,45,45,True,1184,0,336,137,473
355,34,34,True,950,0,242,113,355
356,21,21,True,1120,0,342,119,461
357,2,12,False,812,0,255,135,390
358,20,20,True,1124,0,333,111,444
359,4,8,False,1243,0,377,119,496
360,25,25,True,631,0,196,87,283
361,20,20,True,1256,0,345,147,492
362,23,23,True,1387,0,394,133,527
363,6,6,True,1257,0,377,129,506
364,49,49,True,742,0,209,105,314
365,18,18,True,768,0,201,81,282
366,9,9,True,867,0,208,117,325
367,19,19,True,1812,0,424,128,552
368,18,10,False,883,0,244,82,326
369,1198,1208,False,1348,0,435,146,581
370,320,320,True,701,0,206,97,303
371,50,50,True,894,0,279,137,416
372,5,5,True,677,0,182,103,285
373,240000,240000,True,761,0,212,111,323
374,45,45,True,1299,0,381,92,473
375,48,48,True,684,0,175,103,278
376,15,15,True,1048,0,288,91,379
377,50,50,True,1048,0,284,127,411
378,15,15,True,915,0,257,101,358
379,21,21,True,741,0,181,88,269
380,803,760.42,False,972,0,340,93,433
381,67,67,True,997,0,328,89,417
382,350,350,True,1384,0,418,101,519
383,2,2,True,1260,0,402,147,549
384,32,32,True,960,0,326,83,409
385,16,16,True,1298,0,381,144,525
386,80,80,True,605,0,248,131,379
387,36,36,True,742,0,244,78,322
388,88,88,True,888,0,235,100,335
389,6,12,False,810,0,228,129,357
390,12,12,True,843,0,226,122,348
391,15,15,True,1057,0,328,96,424
392,34,75,False,8090,0,3072,115,3187
393,20,20,True,1476,0,442,88,530
394,92,92,True,788,0,207,95,302
395,38,4,False,1142,0,324,125,449
396,3,3,True,903,0,260,94,354
397,25,25,True,1049,0,291,98,389
398,168,168,True,828,0,261,111,372
399,12,12,True,928,0,268,91,359
400,48,48,True,639,0,176,88,264
401,14400,14400,True,715,0,226,91,317
402,4,4,True,1426,0,397,116,513
403,81,135,False,1678,0,491,120,611
404,22,22,True,1075,0,307,94,401
405,50,50,True,1467,0,454,146,600
406,200,140,False,853,0,262,125,387
407,2000,2000,True,1121,0,375,146,521
408,20,20,True,849,0,266,135,401
409,168000,42000,False,1634,0,477,125,602
410,3,3,True,1117,0,360,159,519
411,1110,1110,True,883,0,274,121,395
412,5,5,True,797,0,213,123,336
413,25,125,False,1164,0,304,114,418
414,56,56,True,813,0,232,94,326
415,350,350,True,1247,0,381,166,547
416,56,56,True,990,0,352,105,457
417,3140,3140,True,997,0,312,146,458
418,40,40,True,707,0,205,100,305
419,3000,3000,True,939,0,266,165,431
420,17000,17000,True,694,0,215,109,324
421,12,12,True,753,0,229,101,330
422,284,240,False,899,0,309,128,437
423,8,4,False,1332,0,412,165,577
424,570,570,True,810,0,242,114,356
425,150,180,False,908,0,251,152,403
426,11,11,True,789,0,271,120,391
427,150,102,False,1306,0,408,125,533
428,26,0,False,1530,0,449,124,573
429,13,13,True,803,0,223,95,318
430,132,132.00,True,830,0,279,127,406
431,1,1,True,1026,0,274,122,396
432,30,30,True,590,0,203,143,346
433,6,6,True,865,0,275,94,369
434,5,5,True,1445,0,434,100,534
435,5,5,True,602,0,178,93,271
436,15,15,True,873,0,248,88,336
437,7,13,False,7480,0,1508,92,1600
438,2,2,True,1113,0,364,135,499
439,17,9,False,1557,0,402,161,563
440,98,98,True,1102,0,367,89,456
441,80,80,True,1170,0,346,120,466
442,49,49,True,1152,0,332,129,461
443,59,51,False,1328,0,457,135,592
444,20,20,True,830,0,253,93,346
445,6,6,True,1513,0,477,123,600
446,2,2,True,917,0,261,118,379
447,5,5,True,681,0,209,101,310
448,539,539,True,1612,0,474,120,594
449,112,112,True,734,0,205,101,306
450,4,1,False,2601,0,664,134,798
451,11050,11050,True,1096,0,397,114,511
452,50,50,True,1184,0,361,94,455
453,6400,6400,True,1066,0,391,108,499
454,150,240,False,719,0,204,78,282
455,1920,1920,True,1380,0,461,125,586
456,78,78,True,885,0,265,102,367
457,45,45,True,593,0,176,129,305
458,35,35,True,943,0,247,92,339
459,2,3,False,1542,0,491,193,684
460,84,84,True,1035,0,266,111,377
461,9,9,True,710,0,214,91,305
462,71,71,True,556,0,174,77,251
463,18,18,True,587,0,175,95,270
464,6,5,False,834,0,265,117,382
465,30,30,True,1317,0,374,125,499
466,1,1,True,838,0,277,103,380
467,1200,1200,True,1071,0,317,103,420
468,120,120,True,1124,0,376,110,486
469,4,4,True,860,0,224,109,333
470,3,3,True,964,0,262,96,358
471,80,80,True,1325,0,379,117,496
472,6,6,True,839,0,228,116,344
473,10,10,True,893,0,254,90,344
474,80,80,True,696,0,187,91,278
475,20,20,True,817,0,222,110,332
476,5,5,True,665,0,191,99,290
477,20,20,True,1058,0,306,98,404
478,621,621,True,768,0,207,105,312
479,15400,15400,True,1054,0,337,122,459
480,11,11,True,839,0,225,101,326
481,84,84,True,745,0,237,124,361
482,26,26,True,542,0,152,121,273
483,40,40,True,903,0,280,112,392
484,240,240,True,809,0,258,113,371
485,220,220,True,801,0,264,88,352
486,6,6,True,695,0,203,86,289
487,4,4,True,1075,0,323,107,430
488,6,6,True,649,0,202,96,298
489,10,10,True,714,0,181,110,291
490,4,4,True,757,0,195,103,298
491,16,16,True,665,0,183,95,278
492,32,32,True,690,0,185,86,271
493,25,100,False,1093,0,361,123,484
494,21,53,False,1608,0,517,137,654
495,200,200,True,845,0,251,102,353
496,38,38,True,584,0,172,85,257
497,112,112,True,1023,0,290,112,402
498,40,40,True,995,0,265,105,370
499,10,7,False,1531,0,462,160,622
500,16,16,True,1039,0,305,90,395
501,273,273,True,1043,0,329,114,443
502,26,26,True,929,0,240,120,360
503,18,18,True,679,0,206,95,301
504,2,2,True,1120,0,312,145,457
505,1,1600,False,1906,0,838,157,995
506,144,144,True,847,0,266,106,372
507,2,2,True,778,0,227,91,318
508,120,125,False,1054,0,321,106,427
509,4,4,True,1098,0,313,107,420
510,525,583,False,1720,0,505,131,636
511,110,110,True,650,0,190,90,280
512,120,120,True,697,0,212,105,317
513,300,300,True,1026,0,315,91,406
514,90000,90000,True,849,0,290,86,376
515,160,288,False,1043,0,316,93,409
516,375,375,True,769,0,210,83,293
517,18,18,True,722,0,213,101,314
518,32,32,True,1194,0,357,117,474
519,280,280,True,681,0,209,84,293
520,63,63,True,728,0,217,154,371
521,39,39,True,1205,0,305,127,432
522,29,29,True,1081,0,311,148,459
523,74,74,True,995,0,289,115,404
524,9,9,True,796,0,229,105,334
525,12,36,False,1018,0,305,140,445
526,21,504,False,1849,0,550,121,671
527,48,240,False,757,0,222,81,303
528,172,102,False,1027,0,300,110,410
529,11,11,True,1655,0,433,96,529
530,36,36,True,1241,0,375,125,500
531,66,66,True,739,0,223,124,347
532,25,25,True,1125,0,368,94,462
533,300,300,True,1109,0,332,108,440
534,300,300,True,1184,0,355,151,506
535,16,16,True,1130,0,272,83,355
536,8,8,True,552,0,184,87,271
537,188,188,True,782,0,249,117,366
538,18,18,True,661,0,198,121,319
539,35,60,False,621,0,197,88,285
540,39,39,True,663,0,220,123,343
541,50,50,True,1512,0,485,113,598
542,7,7,True,875,0,320,108,428
543,6,6,True,787,0,227,95,322
544,80,80,True,686,0,209,85,294
545,30,30,True,569,0,159,90,249
546,130,65,False,856,0,248,104,352
547,81,81,True,812,0,211,103,314
548,100,100,True,718,0,200,88,288
549,398,398,True,894,0,246,101,347
550,27,27,True,1383,0,435,153,588
551,17,17,True,788,0,243,112,355
552,450,450,True,836,0,266,121,387
553,92,92,True,895,0,246,125,371
554,54,54,True,1020,0,300,106,406
555,2,2,True,840,0,247,99,346
556,160,160,True,666,0,190,89,279
557,70,70,True,951,0,263,88,351
558,3,3,True,842,0,248,100,348
559,16,5,False,1657,0,424,121,545
560,45,45,True,757,0,207,96,303
561,180,180,True,1033,0,304,95,399
562,82,82,True,807,0,225,133,358
563,12,12,True,855,0,252,101,353
564,240,240,True,1237,0,369,111,480
565,5,5,True,998,0,268,85,353
566,10,10,True,816,0,271,88,359
567,9,9.00,True,911,0,269,145,414
568,175,175,True,1263,0,379,102,481
569,21,21,True,881,0,229,119,348
570,23,28,False,1702,0,417,123,540
571,308,308,True,639,0,218,103,321
572,100,100,True,1441,0,356,123,479
573,600,600,True,860,0,253,92,345
574,37,10,False,794,0,240,125,365
575,36,36,True,794,0,249,158,407
576,11232,11232,True,1320,0,418,141,559
577,40,64.29,False,1267,0,450,143,593
578,48,48,True,705,0,232,103,335
579,7,7,True,592,0,146,78,224
580,500,499.2,False,851,0,248,109,357
581,215,215,True,738,0,223,101,324
582,129200,129200,True,691,0,238,106,344
583,120,120,True,1196,0,321,114,435
584,2,90,False,939,0,290,109,399
585,40,40,True,1070,0,319,122,441
586,800,800,True,1304,0,424,121,545
587,30,30,True,1285,0,436,143,579
588,52,52,True,976,0,285,121,406
589,15,15,True,1333,0,385,117,502
590,319,318,False,844,0,259,135,394
591,220,220,True,816,0,271,172,443
592,1,1,True,916,0,245,120,365
593,3,3,True,668,0,201,107,308
594,42,42,True,1155,0,331,94,425
595,13,13,True,726,0,229,75,304
596,260,260,True,1045,0,310,145,455
597,90,90,True,989,0,292,100,392
598,69,69,True,1091,0,379,98,477
599,48,48,True,772,0,270,84,354
600,10,10,True,631,0,193,114,307
601,104,99,False,756,0,257,155,412
602,5,5,True,783,0,247,89,336
603,1800,1260,False,1624,0,503,114,617
604,12,12,True,736,0,206,116,322
605,42,42,True,1092,0,335,129,464
606,6,6,True,1579,0,475,108,583
607,10,1200,False,892,0,282,110,392
608,8,8,True,1412,0,422,125,547
609,7,7,True,628,0,179,115,294
610,65,65960,False,953,0,287,99,386
611,1,429292999783,False,2317,0,920,125,1045
612,30,30,True,1001,0,250,132,382
613,93000,93000,True,711,0,195,91,286
614,312,312,True,814,0,251,96,347
615,33,33,True,836,0,327,138,465
616,10,10,True,480,0,141,103,244
617,5,5,True,838,0,243,111,354
618,36,36,True,1502,0,388,116,504
619,76,76,True,1242,0,303,106,409
620,1509,1509,True,914,0,255,110,365
621,3000,3000,True,1006,0,282,108,390
622,7,7,True,1646,0,460,149,609
623,8,8,True,473,0,148,79,227
624,85,85,True,1202,0,308,101,409
625,160,160,True,699,0,206,102,308
626,72,72,True,767,0,217,105,322
627,54,54,True,1133,0,309,97,406
628,4,4,True,1565,0,477,106,583
629,17500,17500,True,1223,0,394,114,508
630,10,10,True,854,0,240,123,363
631,4800,4800,True,1065,0,353,122,475
632,45,45,True,716,0,214,123,337
633,5,5,True,1071,0,310,92,402
634,14,14,True,660,0,202,85,287
635,4,4,True,1428,0,419,116,535
636,1050,1050,True,870,0,221,97,318
637,17,17,True,872,0,283,94,377
638,12,12.00,True,1075,0,375,90,465
639,216,216,True,976,0,300,99,399
640,43,43500,False,934,0,301,187,488
641,262500,378000,False,1249,0,413,100,513
642,10,10800,False,1253,0,425,121,546
643,840,840,True,1309,0,315,109,424
644,29,29,True,523,0,180,103,283
645,48,48,True,648,0,172,89,261
646,79,79,True,1284,0,467,98,565
647,10,10,True,1216,0,340,110,450
648,54,27,False,649,0,178,123,301
649,162000,160000,False,737,0,206,119,325
650,142,142,True,1271,0,406,150,556
651,2100,2100,True,1066,0,307,125,432
652,75,105,False,736,0,231,102,333
653,80,80,True,681,0,180,124,304
654,2,2,True,1065,0,294,108,402
655,10,10,True,692,0,194,89,283
656,10,10,True,1168,0,303,105,408
657,330000,330000,True,1019,0,344,122,466
658,120,120,True,1016,0,318,125,443
659,3,3,True,1270,0,429,114,543
660,15,15,True,1620,0,526,98,624
661,44,44,True,980,0,278,143,421
662,7,7,True,786,0,256,114,370
663,193,193,True,833,0,245,98,343
664,32,32,True,842,0,229,105,334
665,360,360,True,1022,0,258,112,370
666,120,2.5,False,1856,0,618,111,729
667,53,53,True,788,0,222,95,317
668,3,3,True,751,0,183,97,280
669,132,132,True,1051,0,308,106,414
670,4,4,True,674,0,186,102,288
671,4,4,True,845,0,263,119,382
672,2,14,False,1140,0,285,132,417
673,9,9,True,781,0,242,83,325
674,12,12,True,1010,0,305,95,400
675,33,21,False,1060,0,336,155,491
676,240,240,True,991,0,335,111,446
677,36,36,True,724,0,182,168,350
678,120,120,True,895,0,241,86,327
679,576,576,True,833,0,231,79,310
680,20,20,True,1035,0,295,105,400
681,298,298,True,1412,0,411,106,517
682,80,80,True,880,0,291,127,418
683,50,50,True,878,0,246,118,364
684,11,11,True,1100,0,276,111,387
685,14,14,True,927,0,302,108,410
686,80,80,True,910,0,254,109,363
687,13,13,True,946,0,320,93,413
688,100,100,True,769,0,220,120,340
689,7,12.00,False,928,0,343,100,443
690,5760,5760,True,1115,0,340,105,445
691,25,25,True,1415,0,459,111,570
692,32,25,False,1533,0,453,145,598
693,68,68,True,944,0,318,122,440
694,9,17,False,1002,0,257,105,362
695,5,5,True,679,0,216,95,311
696,145,145,True,1078,0,382,162,544
697,27,27,True,675,0,180,133,313
698,720,720,True,948,0,285,117,402
699,8,8,True,618,0,167,85,252
700,135,135,True,1202,0,327,134,461
701,200,200,True,1348,0,373,141,514
702,2800,2800,True,934,0,317,152,469
703,50,50,True,955,0,257,112,369
704,50,50,True,605,0,195,87,282
705,120,120,True,841,0,247,90,337
706,9,6,False,947,0,260,119,379
707,8,8,True,967,0,249,100,349
708,168,168,True,477,0,149,79,228
709,3000,3000,True,1311,0,396,106,502
710,45,45.00,True,894,0,322,142,464
711,6,4,False,853,0,287,109,396
712,14,14,True,1260,0,389,95,484
713,576,576,True,732,0,211,95,306
714,10,10,True,901,0,255,110,365
715,385000,385000,True,1188,0,336,116,452
716,770,770,True,1034,0,331,115,446
717,5,5.00,True,1021,0,333,96,429
718,2,2,True,778,0,227,116,343
719,175,175,True,812,0,219,101,320
720,4,1,False,1294,0,302,96,398
721,2450,2450,True,1617,0,478,172,650
722,255,495,False,1027,0,322,149,471
723,160,160,True,993,0,251,103,354
724,18,18,True,1101,0,324,109,433
725,25,25,True,769,0,244,103,347
726,10,10,True,1038,0,333,125,458
727,112,112,True,1265,0,365,132,497
728,40,40,True,1087,0,348,105,453
729,1000,1000,True,1169,0,426,128,554
730,8,8,True,767,0,221,97,318
731,1,1,True,953,0,289,114,403
732,87,87,True,1376,0,420,109,529
733,5,5,True,470,0,120,94,214
734,17,17,True,693,0,197,119,316
735,50,50,True,1105,0,331,111,442
736,3,3,True,667,0,207,91,298
737,2,2,True,1123,0,342,130,472
738,4,4,True,992,0,266,89,355
739,98,98,True,897,0,269,110,379
740,25,25,True,1088,0,272,114,386
741,28,28,True,610,0,206,103,309
742,24,24,True,714,0,220,99,319
743,8,8,True,569,0,191,120,311
744,4,4,True,773,0,211,128,339
745,1100,1100,True,826,0,269,131,400
746,28,28,True,992,0,281,145,426
747,350,350,True,852,0,241,110,351
748,336,336,True,1116,0,331,93,424
749,3,6,False,971,0,274,89,363
750,4000,4000,True,1211,0,376,110,486
751,43,43,True,824,0,290,159,449
752,240,300,False,788,0,200,89,289
753,128,128,True,988,0,285,109,394
754,89,150,False,2134,0,620,157,777
755,7,7,True,595,0,160,100,260
756,22,22,True,900,0,249,106,355
757,75,75,True,1174,0,423,134,557
758,133,133,True,675,0,212,79,291
759,60000,60000,True,796,0,237,97,334
760,16,16,True,1358,0,400,116,516
761,27,27,True,958,0,298,94,392
762,85,85,True,933,0,267,106,373
763,100,100,True,1214,0,344,120,464
764,14,14,True,1039,0,316,132,448
765,490,490,True,764,0,237,80,317
766,12,12,True,595,0,166,105,271
767,60,60,True,740,0,205,93,298
768,675,600,False,1025,0,284,93,377
769,110,365,False,1161,0,347,119,466
770,4,11,False,1165,0,309,157,466
771,3,3,True,864,0,249,113,362
772,50,50,True,1475,0,411,129,540
773,10,10,True,963,0,297,98,395
774,10,10,True,1145,0,372,96,468
775,276,276,True,1081,0,306,115,421
776,800,800,True,622,0,193,82,275
777,4400,4400,True,1724,0,527,143,670
778,38,38,True,1208,0,408,135,543
779,255,330,False,1423,0,451,119,570
780,25,25,True,1452,0,489,164,653
781,17,2,False,658,0,202,94,296
782,54,27,False,1109,0,313,97,410
783,4,4,True,1580,0,509,157,666
784,15,15,True,1218,0,355,120,475
785,155,35.30,False,980,0,298,99,397
786,142,142,True,895,0,253,108,361
787,25,25,True,811,0,247,111,358
788,100,100,True,906,0,263,103,366
789,4,4,True,1070,0,256,134,390
790,108,108,True,1075,0,307,129,436
791,100,100,True,571,0,176,104,280
792,75,75,True,732,0,213,108,321
793,250,250,True,1020,0,286,121,407
794,32,32,True,892,0,262,95,357
795,20,20,True,1064,0,290,115,405
796,2880000,3120000,False,1266,0,350,115,465
797,540,540,True,864,0,269,119,388
798,20,20,True,1613,0,502,168,670
799,4,4,True,750,0,235,87,322
800,428,428,True,968,0,313,94,407
801,1240,1240,True,1177,0,318,114,432
802,6,6,True,1407,0,440,115,555
803,9,9,True,1203,0,342,111,453
804,20,20,True,1219,0,375,119,494
805,1170,1170,True,717,0,217,101,318
806,70,70,True,1036,0,337,129,466
807,4,4,True,995,0,269,117,386
808,12,12,True,1003,0,287,105,392
809,50,100,False,966,0,250,140,390
810,310,310,True,879,0,253,116,369
811,60,60,True,1147,0,328,134,462
812,79,79,True,1339,0,413,170,583
813,7,7,True,1154,0,341,138,479
814,11,2.50,False,1921,0,582,136,718
815,4,4,True,1350,0,354,130,484
816,4500,4500,True,697,0,223,88,311
817,15,15,True,664,0,170,89,259
818,16,16,True,1135,0,336,109,445
819,6,6250,False,789,0,235,109,344
820,720,720,True,917,0,252,114,366
821,35,35,True,851,0,246,129,375
822,1260,1260,True,860,0,270,97,367
823,14,18,False,896,0,229,151,380
824,52,52,True,940,0,258,109,367
825,153,153,True,1161,0,398,117,515
826,27,27,True,775,0,253,122,375
827,11,0,False,1360,0,391,137,528
828,60,60,True,521,0,207,96,303
829,14,14000,False,1207,0,355,130,485
830,1128,1128,True,1145,0,335,119,454
831,324,3096,False,1736,0,494,140,634
832,42,42,True,814,0,268,105,373
833,40,40,True,909,0,298,127,425
834,80,80,True,884,0,275,99,374
835,48,27,False,1127,0,316,102,418
836,140,140,True,1039,0,321,114,435
837,120,120,True,1321,0,392,178,570
838,15,15,True,1384,0,354,110,464
839,2,2,True,1383,0,356,93,449
840,16,16,True,1202,0,402,116,518
841,5600,5600,True,864,0,244,107,351
842,10,10,True,656,0,190,91,281
843,19,19,True,1114,0,325,94,419
844,180,180,True,1428,0,471,101,572
845,12,12,True,989,0,248,102,350
846,11,6,False,1027,0,275,122,397
847,975,2325,False,962,0,304,93,397
848,10,10,True,1188,0,320,106,426
849,75,75,True,825,0,239,94,333
850,70,70,True,1019,0,284,112,396
851,110,110,True,862,0,235,89,324
852,123,123,True,1032,0,287,107,394
853,15,INVALID,False,3138,0,3072,94,3166
854,144,144,True,1029,0,315,130,445
855,13,13,True,1482,0,607,105,712
856,7,7,True,1189,0,313,125,438
857,14000,14000,True,865,0,239,133,372
858,3430,3430,True,877,0,286,79,365
859,1520,1520,True,950,0,279,106,385
860,3,3,True,1262,0,314,89,403
861,30,30,True,1374,0,403,113,516
862,40,40,True,947,0,285,133,418
863,110,110,True,1090,0,296,90,386
864,80,80,True,935,0,249,116,365
865,23,23,True,874,0,287,121,408
866,28,28,True,1437,0,514,101,615
867,7,7,True,606,0,157,108,265
868,15,15,True,1012,0,303,137,440
869,500,500,True,607,0,178,88,266
870,40,40,True,964,0,281,107,388
871,48,48,True,1063,0,345,113,458
872,13,13.00,True,1289,0,414,96,510
873,12,12.00,True,606,0,178,98,276
874,132,132,True,707,0,210,88,298
875,60,60,True,930,0,276,92,368
876,41,41,True,1202,0,328,149,477
877,7000,7000,True,951,0,286,131,417
878,5,5,True,959,0,271,101,372
879,575,575,True,730,0,252,108,360
880,10,38.5,False,993,0,282,116,398
881,16,16,True,870,0,265,81,346
882,5,5,True,1827,0,548,166,714
883,25,25,True,1004,0,276,124,400
884,50,50,True,659,0,219,94,313
885,500,500,True,866,0,260,106,366
886,20,20,True,808,0,228,117,345
887,34,34,True,887,0,278,93,371
888,10,10,True,686,0,181,83,264
889,15,15,True,1116,0,316,105,421
890,25,25,True,1431,0,379,100,479
891,55,55,True,1135,0,374,111,485
892,1,1,True,917,0,265,110,375
893,480,480,True,921,0,256,100,356
894,26,26,True,1718,0,536,133,669
895,74,74,True,705,0,258,109,367
896,250,250,True,1169,0,342,101,443
897,1,1,True,1095,0,311,93,404
898,110,110,True,941,0,311,131,442
899,16,16,True,672,0,189,103,292
900,15,12,False,917,0,249,117,366
901,1,2,False,1142,0,316,129,445
902,8,8,True,824,0,260,94,354
903,16,16,True,1323,0,394,108,502
904,8,8,True,758,0,191,95,286
905,5,5,True,835,0,276,97,373
906,10,10,True,987,0,289,105,394
907,16,16,True,620,0,171,84,255
908,14,14,True,634,0,188,88,276
909,38,38,True,1077,0,377,89,466
910,700,700,True,1109,0,329,91,420
911,64,64,True,884,0,247,112,359
912,6,6,True,1033,0,272,98,370
913,6,6,True,1164,0,369,124,493
914,3,3,True,648,0,223,97,320
915,23,23,True,878,0,244,101,345
916,14,14,True,1025,0,337,148,485
917,12,12,True,770,0,208,86,294
918,56,56,True,794,0,197,97,294
919,90,90,True,1141,0,355,134,489
920,47,47,True,976,0,326,135,461
921,4,4,True,863,0,233,89,322
922,60,60,True,765,0,209,89,298
923,2,4.5,False,836,0,254,126,380
924,12,12,True,873,0,254,152,406
925,2000,2000,True,1308,0,367,136,503
926,1,1,True,1781,0,496,180,676
927,85000,85000,True,1126,0,318,126,444
928,60,60,True,1149,0,371,129,500
929,60,60,True,1204,0,376,94,470
930,14,14,True,987,0,270,143,413
931,50,50,True,1153,0,438,102,540
932,24,24,True,1242,0,342,120,462
933,15,15,True,1230,0,336,118,454
934,410,410,True,989,0,295,128,423
935,64800,64800,True,1516,0,542,148,690
936,250,100,False,1098,0,355,169,524
937,159,159,True,1237,0,345,105,450
938,4,4,True,1607,0,492,116,608
939,650,650,True,1131,0,277,133,410
940,280,280,True,753,0,202,105,307
941,842,842,True,1289,0,311,128,439
942,205,178.75,False,919,0,393,109,502
943,50,110,False,1503,0,437,105,542
944,34,34,True,915,0,302,114,416
945,17,17,True,1727,0,509,140,649
946,450,450,True,545,0,162,96,258
947,13,13,True,741,0,192,108,300
948,15,15,True,1195,0,343,137,480
949,42,42,True,489,0,164,79,243
950,5,INVALID,False,3260,0,3072,108,3180
951,300,300,True,1235,0,307,110,417
952,360,1800,False,1078,0,344,97,441
953,452,475,False,1159,0,384,164,548
954,34,34,True,1078,0,277,96,373
955,100,100,True,1406,0,400,105,505
956,1,1,True,887,0,239,98,337
957,45,45,True,729,0,240,95,335
958,40,40,True,586,0,173,112,285
959,7,7,True,942,0,237,165,402
960,11,11,True,1407,0,412,170,582
961,225,225,True,722,0,211,124,335
962,1000,600,False,764,0,230,107,337
963,147,147,True,1678,0,598,124,722
964,200,200,True,942,0,228,102,330
965,374,374,True,1309,0,342,186,528
966,48,48,True,1187,0,352,160,512
967,30,30,True,790,0,290,93,383
968,227,227,True,799,0,267,174,441
969,1800,1800,True,845,0,273,101,374
970,33,33,True,785,0,206,86,292
971,100,100,True,729,0,223,101,324
972,120,80,False,1285,0,375,114,489
973,79,79,True,887,0,249,79,328
974,5,5,True,798,0,220,114,334
975,20,20,True,1108,0,364,97,461
976,540,540,True,1701,0,539,139,678
977,4,4,True,999,0,266,109,375
978,160,160,True,806,0,258,85,343
979,50,50,True,1360,0,457,102,559
980,90,90,True,800,0,242,109,351
981,7,7,True,1083,0,303,106,409
982,12,12,True,1244,0,329,126,455
983,15,15,True,922,0,259,84,343
984,342,168,False,1291,0,463,138,601
985,63,63,True,761,0,221,85,306
986,70,70,True,1043,0,305,122,427
987,3,3,True,1249,0,363,120,483
988,6,0,False,894,0,277,112,389
989,45,30,False,1071,0,327,88,415
990,14,10,False,1620,0,396,140,536
991,15,15,True,1608,0,462,117,579
992,52,0,False,4913,0,1797,125,1922
993,11,11,True,1233,0,346,142,488
994,2,2,True,941,0,299,151,450
995,12,12,True,1046,0,272,94,366
996,3,INVALID,False,3175,0,3072,121,3193
997,6,6600,False,1116,0,272,137,409
998,50,50,True,1100,0,301,132,433
999,25,25,True,996,0,300,100,400
1000,1,1,True,1209,0,341,133,474
1001,2,2,True,989,0,313,158,471
1002,8,8,True,699,0,216,101,317
1003,480,480,True,909,0,250,116,366
1004,8,8,True,1092,0,343,115,458
1005,1490,1490,True,1184,0,362,112,474
1006,826,826,True,1039,0,349,161,510
1007,34,34,True,767,0,235,105,340
1008,230,230,True,1090,0,351,96,447
1009,1,1875,False,1264,0,436,135,571
1010,5,5,True,773,0,260,116,376
1011,6000,6000,True,1792,0,618,193,811
1012,94,56,False,1267,0,457,172,629
1013,2,2,True,942,0,312,132,444
1014,3,3,True,1277,0,476,143,619
1015,78,78,True,1429,0,394,102,496
1016,138,139,False,996,0,387,117,504
1017,45,45,True,1114,0,305,104,409
1018,60,60,True,568,0,172,100,272
1019,98,176,False,991,0,298,130,428
1020,22,22,True,591,0,160,91,251
1021,36,36,True,1653,0,466,117,583
1022,12,12,True,1247,0,342,108,450
1023,77,77,True,772,0,198,91,289
1024,300,300,True,1066,0,280,98,378
1025,30,40,False,587,0,166,96,262
1026,43200,43200,True,1210,0,386,123,509
1027,12,12,True,966,0,252,117,369
1028,200,200,True,696,0,200,116,316
1029,34,34,True,1176,0,365,176,541
1030,24,70,False,2524,0,608,164,772
1031,5,5,True,1097,0,284,118,402
1032,450,450,True,662,0,189,132,321
1033,2,2,True,1456,0,411,110,521
1034,66,66,True,705,0,206,89,295
1035,35,35,True,1204,0,298,155,453
1036,10,10,True,750,0,208,98,306
1037,10,6,False,11955,0,3072,118,3190
1038,4,4,True,1504,0,481,135,616
1039,160,160,True,656,0,197,109,306
1040,736,736,True,1299,0,361,110,471
1041,101,101,True,773,0,224,112,336
1042,3,7.17,False,985,0,332,128,460
1043,130000,130000,True,1080,0,294,103,397
1044,1,1,True,932,0,284,116,400
1045,420,420,True,788,0,264,92,356
1046,189,47.25,False,1237,0,381,89,470
1047,10,10,True,1594,0,487,127,614
1048,7400,9848.18,False,822,0,358,104,462
1049,20,20,True,884,0,246,93,339
1050,655,1630,False,645,0,159,98,257
1051,15,15,True,699,0,212,89,301
1052,110,110,True,684,0,222,126,348
1053,55,55,True,1004,0,306,145,451
1054,2400,2400,True,843,0,244,107,351
1055,2304,2304,True,835,0,238,95,333
1056,156,52,False,1056,0,292,113,405
1057,24,24,True,892,0,239,93,332
1058,250,250,True,820,0,234,106,340
1059,2,6,False,858,0,252,89,341
1060,31,31,True,1021,0,343,110,453
1061,58,58,True,943,0,301,96,397
1062,482,482,True,1042,0,346,128,474
1063,320,320,True,799,0,220,100,320
1064,247,247,True,809,0,274,117,391
1065,95,95,True,783,0,258,87,345
1066,14,14,True,961,0,312,93,405
1067,245,245,True,1172,0,344,113,457
1068,24,24,True,1220,0,319,110,429
1069,300,300,True,1077,0,281,158,439
1070,18,18.00,True,1337,0,477,128,605
1071,251,251,True,950,0,286,135,421
1072,85,85,True,1088,0,320,90,410
1073,21,21,True,1284,0,392,123,515
1074,750,750,True,678,0,198,93,291
1075,16,20,False,839,0,252,108,360
1076,162,162,True,765,0,249,101,350
1077,145,110,False,1427,0,465,240,705
1078,8,8,True,1028,0,307,148,455
1079,10,10,True,1286,0,378,119,497
1080,72000,72000,True,713,0,226,85,311
1081,195,195,True,602,0,190,101,291
1082,2,1,False,1198,0,328,109,437
1083,2,2,True,982,0,261,112,373
1084,20,80,False,964,0,308,92,400
1085,26,26,True,610,0,186,81,267
1086,131250,153750,False,2625,0,1711,172,1883
1087,12,12,True,938,0,284,127,411
1088,30,85,False,1529,0,438,130,568
1089,32,32,True,897,0,250,111,361
1090,72,72,True,1147,0,336,121,457
1091,1000,1000,True,777,0,220,97,317
1092,1080,1080,True,711,0,234,129,363
1093,144,144,True,1335,0,399,115,514
1094,25,25,True,1084,0,313,150,463
1095,270,270,True,869,0,252,98,350
1096,240,240,True,1155,0,364,129,493
1097,480,480,True,836,0,240,106,346
1098,30,30,True,511,0,171,98,269
1099,2,2,True,1278,0,336,126,462
1100,5,5,True,1072,0,297,93,390
1101,16,16,True,780,0,223,95,318
1102,113,113.00,True,1107,0,427,155,582
1103,90,90,True,804,0,250,124,374
1104,24,24,True,525,0,163,80,243
1105,40,22,False,1143,0,380,114,494
1106,5,5,True,626,0,211,95,306
1107,360,360,True,837,0,272,78,350
1108,38,38,True,453,0,125,105,230
1109,3,3,True,951,0,250,86,336
1110,60,60,True,1395,0,401,131,532
1111,157,157,True,874,0,249,108,357
1112,5,5,True,1085,0,303,91,394
1113,3,3,True,583,0,153,91,244
1114,8,8,True,672,0,217,92,309
1115,5,7,False,714,0,207,118,325
1116,60,60,True,1021,0,270,94,364
1117,9,9,True,659,0,205,85,290
1118,5,5,True,1032,0,323,130,453
1119,18,18,True,915,0,283,160,443
1120,560,560,True,977,0,286,98,384
1121,35,35,True,948,0,256,90,346
1122,18,18,True,1254,0,351,149,500
1123,105,105,True,966,0,286,109,395
1124,64,64,True,962,0,334,103,437
1125,90,90,True,880,0,264,109,373
1126,50,50,True,914,0,267,109,376
1127,750,750,True,666,0,206,138,344
1128,9,9,True,904,0,256,82,338
1129,8,8,True,1477,0,519,113,632
1130,25,25,True,1273,0,405,133,538
1131,96,96,True,735,0,251,118,369
1132,45000,45000,True,1186,0,370,94,464
1133,50,50,True,1764,0,532,140,672
1134,7,7,True,936,0,260,99,359
1135,32,32,True,918,0,256,95,351
1136,26,26,True,921,0,284,101,385
1137,68,68,True,1863,0,457,138,595
1138,700,700,True,1225,0,405,117,522
1139,1,1.00,True,1098,0,360,121,481
1140,27,27,True,1003,0,310,101,411
1141,20,20,True,909,0,284,95,379
1142,9,9,True,1225,0,322,120,442
1143,300,300,True,758,0,230,83,313
1144,34,34,True,918,0,311,105,416
1145,291,291,True,1254,0,361,127,488
1146,16,16,True,1066,0,337,114,451
1147,22,22,True,1218,0,323,150,473
1148,9,9,True,599,0,160,84,244
1149,93,93,True,812,0,227,85,312
1150,21,21,True,684,0,194,87,281
1151,50,50,True,953,0,266,89,355
1152,12,12,True,1254,0,351,96,447
1153,20,20,True,1153,0,377,122,499
1154,30,30,True,964,0,260,86,346
1155,13,13,True,646,0,202,89,291
1156,120,120,True,1151,0,312,117,429
1157,3,3,True,599,0,209,110,319
1158,7300,0,False,969,0,279,129,408
1159,50,50,True,1840,0,590,116,706
1160,1125,1125,True,1218,0,312,106,418
1161,170,140,False,1401,0,397,124,521
1162,3,3,True,574,0,190,80,270
1163,12,12,True,784,0,225,88,313
1164,9,9,True,1186,0,401,112,513
1165,1248,416,False,1261,0,387,125,512
1166,2350,1750,False,757,0,252,171,423
1167,120,120,True,512,0,166,81,247
1168,20,20,True,1340,0,422,107,529
1169,2,2,True,1050,0,322,106,428
1170,2,2,True,1116,0,330,120,450
1171,3160,3160,True,1046,0,337,117,454
1172,93,93,True,981,0,343,133,476
1173,10,10,True,843,0,282,111,393
1174,240,240,True,1138,0,394,130,524
1175,16,16,True,1022,0,295,129,424
1176,2,2,True,1363,0,432,201,633
1177,17,17,True,1259,0,357,95,452
1178,17,17,True,717,0,195,80,275
1179,50,36.67,False,938,0,281,87,368
1180,5600,5600,True,760,0,256,136,392
1181,20,20,True,2017,0,703,93,796
1182,1800,1800,True,776,0,266,94,360
1183,11,10,False,1226,0,309,167,476
1184,306,306,True,646,0,203,94,297
1185,6,6,True,1381,0,369,106,475
1186,19,19,True,782,0,227,86,313
1187,5,5,True,1184,0,355,104,459
1188,24,4,False,1213,0,361,88,449
1189,6,6,True,704,0,194,99,293
1190,19,34,False,1514,0,502,150,652
1191,100,100,True,929,0,280,102,382
1192,280,280,True,977,0,282,120,402
1193,9,9.00,True,1062,0,364,144,508
1194,1200,1200,True,943,0,262,106,368
1195,320,320,True,958,0,299,174,473
1196,75,75,True,861,0,251,92,343
1197,2400,2400,True,1186,0,368,101,469
1198,140,140,True,1265,0,354,136,490
1199,2,2,True,928,0,268,209,477
1200,8,8,True,749,0,222,85,307
1201,42,42,True,1340,0,355,99,454
1202,19,19,True,989,0,274,110,384
1203,240,540,False,1180,0,342,107,449
1204,168,168,True,1190,0,344,131,475
1205,4,4,True,972,0,262,119,381
1206,40,40000,False,1044,0,329,119,448
1207,64,64,True,822,0,233,124,357
1208,27,27,True,604,0,186,85,271
1209,29,29,True,1081,0,326,214,540
1210,288,288,True,884,0,228,112,340
1211,448,448,True,950,0,260,93,353
1212,150,150,True,803,0,228,117,345
1213,31,31,True,1213,0,352,122,474
1214,5,5,True,932,0,246,92,338
1215,36,36,True,1146,0,382,164,546
1216,20,20,True,1142,0,350,148,498
1217,75,75,True,1331,0,413,127,540
1218,225,225,True,905,0,246,156,402
1219,100,100,True,764,0,201,94,295
1220,32,32,True,903,0,257,97,354
1221,10,10,True,927,0,251,125,376
1222,350,350,True,661,0,183,98,281
1223,8,8.00,True,811,0,267,104,371
1224,5,5,True,906,0,254,89,343
1225,3,3,True,1058,0,355,101,456
1226,90,90,True,1070,0,297,121,418
1227,66,66,True,1201,0,315,108,423
1228,31,31,True,693,0,198,89,287
1229,36,36,True,868,0,300,98,398
1230,440,440,True,1042,0,314,150,464
1231,70,70,True,623,0,315,106,421
1232,15,15,True,596,0,181,100,281
1233,81,81,True,1134,0,333,106,439
1234,12,12,True,786,0,216,87,303
1235,60,60,True,1532,0,432,118,550
1236,84,84,True,1022,0,295,118,413
1237,78,78,True,682,0,174,93,267
1238,520,520,True,810,0,252,118,370
1239,50,250,False,1486,0,393,109,502
1240,2,2,True,973,0,284,132,416
1241,8,8,True,977,0,295,87,382
1242,20,20,True,1137,0,330,106,436
1243,50,50,True,809,0,280,109,389
1244,35,35,True,1325,0,328,139,467
1245,96,96,True,970,0,306,114,420
1246,3360,3360,True,697,0,194,100,294
1247,7,7,True,604,0,187,142,329
1248,750,750,True,762,0,222,164,386
1249,56,52,False,1524,0,437,163,600
1250,22,22,True,532,0,148,97,245
1251,30,32.5,False,832,0,343,125,468
1252,70,70,True,974,0,291,98,389
1253,120,120,True,1151,0,324,94,418
1254,30,30,True,1201,0,318,144,462
1255,12,12,True,1311,0,403,121,524
1256,15,15,True,1321,0,387,157,544
1257,14,14,True,675,0,186,105,291
1258,60,70,False,886,0,236,92,328
1259,7200,7200,True,956,0,274,92,366
1260,5,5,True,1050,0,280,134,414
1261,235,235,True,1127,0,386,131,517
1262,12,12,True,959,0,337,119,456
1263,500,400,False,1018,0,326,163,489
1264,210,210,True,7185,0,3072,186,3258
1265,36,30,False,840,0,236,151,387
1266,147,147,True,1074,0,312,106,418
1267,40,40,True,1038,0,283,90,373
1268,20,20,True,875,0,276,97,373
1269,54,54,True,967,0,238,108,346
1270,3528,3528,True,904,0,338,110,448
1271,43,43,True,1082,0,309,104,413
1272,296,296,True,907,0,284,127,411
1273,27,27,True,782,0,207,104,311
1274,38,38,True,945,0,256,103,359
1275,16,16,True,955,0,293,125,418
1276,70,70,True,500,0,151,109,260
1277,48,48,True,678,0,210,90,300
1278,665,665,True,758,0,244,110,354
1279,180,180,True,767,0,246,131,377
1280,7,7,True,742,0,216,98,314
1281,20,20,True,1183,0,350,93,443
1282,12,12,True,1309,0,368,116,484
1283,60,60,True,1279,0,362,98,460
1284,25,25,True,911,0,249,148,397
1285,1218,1218,True,724,0,197,125,322
1286,105,105,True,912,0,292,92,384
1287,84,84,True,914,0,251,110,361
1288,34,34,True,1667,0,467,108,575
1289,101,101,True,922,0,259,142,401
1290,90,90,True,947,0,271,89,360
1291,27,27,True,841,0,228,89,317
1292,67,67,True,707,0,217,98,315
1293,140000,140000,True,886,0,232,102,334
1294,36,36,True,991,0,285,139,424
1295,2,2,True,1547,0,431,121,552
1296,335,335,True,848,0,260,122,382
1297,60,60,True,998,0,362,151,513
1298,31,31,True,1016,0,335,101,436
1299,13,13,True,838,0,249,112,361
1300,120,120,True,947,0,297,99,396
1301,23,23,True,780,0,265,130,395
1302,72,72,True,1034,0,289,117,406
1303,4,4,True,1393,0,402,117,519
1304,1000,1000,True,993,0,245,114,359
1305,2325,2325,True,1194,0,324,107,431
1306,2,2,True,1345,0,425,190,615
1307,8,8,True,937,0,253,93,346
1308,30,30,True,655,0,167,85,252
1309,2280,2180,False,738,0,229,113,342
1310,64,16,False,1902,0,584,122,706
1311,594,,False,6166,0,3072,114,3186
1312,180,30,False,1040,0,276,100,376
1313,2,2,True,1080,0,308,88,396
1314,8,8,True,763,0,245,113,358
1315,5,5,True,837,0,228,110,338
1316,230,230,True,895,0,281,127,408
1317,5,5,True,1296,0,417,91,508
1318,14,14,True,934,0,249,96,345

